...#######.
..##...#.@#
.####......
.......####
###.#.###..
#...######.
.....#####.
###........
....#######
#.######...
#.#######..